00000000000000000000000000000000
00011111000000000000000000000000
00010001000000001111111111111111
00010001000000001000000000000000
00010001000000001000000000000000
11010001000000001000000000000000
01110001000000001000000000000000
00000001000000001111111111100000
00000001000000000000000000100000
00000001000000000000000000100000
11111111111111111111111111111111
00000001002222222222222200100000
00000001002222222222222200100000
00000001002222222222222200100000
00000001002222222222222200100000
00000001002222222222222200100000
00000001000000000000000000100000
00000001111111111100000000100000
00000000000000000100000000100000
00000000000000000100000000100000
00000000000000000100000000100000
00000000000000000100000000100000
00000000000000000100000000100000
00000000000000000100000000100000
00000000000000000100000000100000
00000000000000000100000000100000
00000000000000000111111111100000
00000000000000000000000000000000
00000000000000000000000000000000
00000000000000000000000000000000
00000000000000000000000000000000
00000000000000000000000000000000
