00000000000000000000000000000000
00000000000000000000001111111111
00000000000000000000001000000000
00000000000000000000111111111111
00000000001111111100101000000000
11000000001022200100101000000000
01111110001022200100101000000000
00000010001022200100101000000000
00000011111022200100101000000000
00000000000022200100101000000000
00000000000000000100101000000000
00000000000000000100101000000000
11111111111111111111101000000000
00000000000000000100001000000000
00000000000000000100001000000000
00000000000000000100001000000000
00000000000000000100001000000000
00000000000000000111111000000000
00000000000000000000000000000000
00000000000000000000000000000000
00000000000000000000000000000000
00000000000000000000000000000000
00000000000000000000000000000000
00000000000000000000000000000000
00000000000000000000000000000000
00000000000000000000000000000000
00000000000000000000000000000000
00000000000000000000000000000000
00000000000000000000000000000000
00000000000000000000000000000000
00000000000000000000000000000000
00000000000000000000000000000000