00000000000000000000000000000000
00000000000000000000000000000000
00000000000000000000000000000000
00000000000000000000000000000000
00000000001111111100000000000000
11000000001000000100000000000000
01111110001000000100000000000000
00000010001000000100000000000000
00000011111000000100000000000000
00000000000000000100000000000000
11111111111111111111111111111111
00000000000000000100222222222222
00000000000000000100222222222222
00000000000000000100222222222222
00000000000000000100222222222222
00000000000000000100222222222222
00000000000000000100222222222222
00000000000000000111111111111111
00000000000000000000222222222222
00000000000000000000222222222222
00000000000000000000000000000000
00000000000000000000000000000000
00000000000000000000000000000000
00000000000000000000000000000000
00000000000000000000000000000000
00000000000000000000000000000000
00000000000000000000000000000000
00000000000000000000000000000000
00000000000000000000000000000000
00000000000000000000000000000000
00000000000000000000000000000000
00000000000000000000000000000000
