00000000000000000000000000000000
00011111000000000000000000000000
00010001000000001111111111111111
00010001000000001000000000000000
00010001000000001000000000000000
11010001000000001000000011111111
01110001000000001000000010000000
00000001000000001111111111100000
00000001000000000000000010100000
00000001000000000000000010100000
00000001002222222222222010100000
00000001002222222222222010100000
00000001000000000000000010100000
00000001000000000000000010100000
00011111111111111111111110100000
00010001000000000000000000100000
00010001111111111100000000100000
00010000000000000100000000100000
00010000000000000100000000100000
00010000000000000100000000100000
00010000000000000100000000100000
00010000000000000100000000100000
00010000000000000100000000100000
11110000000000000100000000100000
00000000000000000100000000100000
00000000000000000111111111100000
00000000000000000000000000000000
00000000000000000000000000000000
00000000000000000000000000000000
00000000000000000000000000000000
00000000000000000000000000000000
00000000000000000000000000000000
