00000000000000000000000000000000
00000000000000000000000000000000
00000000000000000000000000000000
00000000000000000000000000000000
00000000000000000000000000000000
00000000000000000000000000000000
00000000000000000000000000000000
00000000000000000000000000000000
00000000000000000000000000000000
11111111111111111110000000000000
22222222222222222210000000000000
11111111111112222210000000000000
00000000000012222210000000000000
00000000011111111111110000000000
00000000010010000010010000000000
00000000012212222212210000000000
11111111112212222212211111111111
00000000002212222212200000000000
11111111112212222212211111111111
00000000012212222212210000000000
00000000010010000010010000000000
00000000011111111111110000000000
00000000000012222210000000000000
00000000000012222211111111111111
00000000000012222222222222222222
00000000000011111111111111111111
00000000000000000000000000000000
00000000000000000000000000000000
00000000000000000000000000000000
00000000000000000000000000000000
00000000000000000000000000000000
00000000000000000000000000000000